1111111111111111111111111111111111
1E00C00000000000000000000000000001
1011110100100000101001000C00010101
1011110010101010001001C00000010101
10C0000P0000000000000000111000C001
1C11110000100000101001000000010101
101111001C101010001C01000000010101
10111101C010000010100100000001C101
1011110010101010001001000000010101
1011110100100000101001000000C10101
1011110010101010001C01000000010101
1111111111111111111111111111111111
