11111111111111111111
100000CC0000CCC00E01
10000C0C000C000C0001
1000C00C0000000C0001
100C000C0000000C0001
100CCCCCC00000C00001
1000000C00000C000001
10000000C000C0000001
1000P00C000CCCCC0001
11111111111111111111
