11111111111111111111
101000CC0000CCC00E01
10000C0C000C000C0001
1000C00C0000000C0001
101C000C0000000C0001
100CCCCCC00000C00001
1000000C00000C000001
1000100C0000C0000001
100000000P0CCCCC0001
11111111111111111111
