1111111111111111111111111111111111
1E00C0000000000C00000C000000X00001
111001X100100000101001000X0001X101
101001001010101000100100000001C101
1P00000000000000000X00000000000C01
10100100101010100010010000C0010101
1010010010101010001001000000010101
1111111111111111111111111111111111
