1111111111111111111111111111111111
1CE0C0000000000C00X00C000000000001
1110010100100000101001000000010101
101001001010101000100100000001C101
1P00000000000000000000000X00000C01
10100100101010100010010X00C0010101
1C10010010101010X01001000000010001
101X01X0101010100010010X00C0010101
1C10010010101010001001000000010001
1111111111111111111111111111111111
